8,6,1,2,
2,3,1,1,
6,3,1,1,

00,00,00,00,00,00,00,00,
00,00,00,00,00,00,00,00,
01,01,01,01,01,01,01,01,
01,01,00,01,01,01,00,01,
01,01,01,01,01,01,01,01,
01,01,01,01,01,01,01,01,