32,5,1,7,
3,3,2,1,
0,4,2,1,
6,4,1,1,
8,3,1,1,
10,4,2,1,
13,3,1,1,
15,4,18,1,


00,00,00,00,00,00,00,00,00,00,00,00,00,00,00,00,00,00,00,00,00,00,00,00,00,00,00,00,00,00,00,00,
00,00,00,00,00,00,00,00,00,00,00,00,00,00,00,00,00,00,00,00,00,00,00,00,00,00,00,00,00,00,00,00,
00,00,00,00,00,00,00,00,00,00,00,00,00,00,00,00,00,00,00,00,00,00,00,00,00,00,00,00,00,00,00,00,
01,01,01,03,06,01,01,01,05,01,01,01,01,05,01,01,01,01,01,01,01,01,01,01,01,01,01,01,01,01,01,01,
00,06,01,01,01,01,04,01,01,01,02,06,01,01,01,02,00,00,00,00,00,00,00,00,00,00,00,00,00,00,00,00,
